C         100,100,0
WE cub3d.c
F  89,98,8

EA utils.c

SO        cub3d.h
NO  raycast.c

1111111111111111111111111
1000000000110000000000001
1011000001110000000000001
1001000001000001000000001
100010001000010N011000001
1000000000000001000000001
1000000000001001000000001
1000000000000000000000001
1100000011010101110000001
1000000000000000000000001
1000000000000000000000001
1000000000110000000000001
1000010000000000000000001
1111111111111111111111111